NO ./wall/north.xpm
SO ./wall/south.xpm
EA ./wall/east.xpm
WE ./wall/west.xpm
F 51,36,33
C 1,50,32


1111111
1N10011111
 1110000001
1111111001
100011111
100111111111
100110101
11111111111