NO ./wall/north.xpm
SO ./wall/south.xpm
WE ./wall/west.xpm
EA ./wall/east.xpm
F 100,100,100
C 135,206,235

111111111
10S000001
100000001
100000001
111111111

111111111
100000001
111111111
