NO ./wall/north.xpm
SO ./wall/south.xpm
EA ./wall/east.xpm
WE ./wall/west.xpm
F 220,100,0
C 225,30,0


1111111
1111001111
  110000001
1111111001
100011111
1001111
10N0110111
1111111