1111111
1100001
1000001
1000001
1000101
10000N1
1111111