NO ./wall/north.xpm
SO ./wall/south.xpm
WE ./wall/west.xpm
EA ./wall/east.xpm
F 50,50,50
C 195,206,235

111111111
1000000001
1000000001
1111110001
1111111101
1001111101
1000001101
1001101101
1001101101
1011000101
1N11000101
11111100011
111111111
