NO ./wall/north.xpm
SO ./wall/south.xpm
EA ./wall/east.xpm
WE ./wall/west.xpm
F 51,36,33
C 1,50,32

    111111111
   10000000001
    100000001
     1000001
      10N01
       101
        1