SO ./assets/south.xpm
NO ./assets/north.xpm
WE ./assets/west.xpm
EA ./assets/east.xpm
F 1,50,33
C 139,0,0

1111
10001
10N01
10001
1111
